38 38 38 38 38 38 38 38 38 38 38 38 38 38 38 38 38 38 38 38 38 38 38 38 38 38 38 38 38 38 38 38 38 38 38 38 38 38 38 38 38 38 38 38 38
38 15 12 12 12 12 12 12 12 12 12 12 12 12 12 12 12 12 12 12 12 12 12 12 12 12 12 12 12 12 12 12 12 12 12 12 12 12 12 12 12 12 12 16 38
38 14 10 10 10 10 10 10 10 10 10 10 10 10 10 10 10 10 10 10 10 10 10 10 10 10 10 10 10 10 10 10 10 10 10 10 10 10 10 10 10 10 10 13 38
38 14 10 10 10 10 10 10 10 10 10 10 10 10 10 10 10 10 10 10 10 10 10 10 10 10 10 10 10 10 10 10 10 10 10 10 10 10 10 10 10 10 10 13 38
38 14 10 10 10 10 10 10 10 10 10 10 10 10 10 10 10 10 10 10 10 10 10 10 10 10 10 10 10 10 10 10 10 10 10 10 10 10 10 10 10 10 10 13 38
38 14 10 10 10 10 10 10 10 10 10 10 10 10 10 10 10 10 10 10 10 10 10 10 10 10 10 10 10 10 10 10 10 10 10 10 10 10 10 10 10 10 10 13 38
38 14 10 10 10 10 10 10 10 10 10 10 10 10 10 10 10 10 10 10 10 10 10 10 10 10 10 10 10 10 10 10 10 10 10 10 10 10 10 10 10 10 10 13 38
38 14 10 10 10 10 10 10 10 10 10 10 10 10 10 10 10 10 10 10 10 10 10 10 10 10 10 10 10 10 10 10 10 10 10 10 10 10 10 10 10 10 10 13 38
38 14 10 10 30 27 27 27 27 27 27 27 27 27 27 27 27 27 27 27 27 27 27 27 27 27 27 27 27 27 27 27 27 27 27 31 10 10 10 10 10 10 10 13 38
38 14 10 10 29 25 25 25 25 25 25 25 25 25 25 25 25 25 25 25 25 25 25 25 25 25 25 25 25 25 25 25 25 25 25 28 10 10 10 10 10 10 10 13 38
38 14 10 10 32 26 26 26 26 26 26 26 26 26 26 26 26 26 35 25 34 26 26 26 26 26 26 26 26 26 26 26 26 35 25 28 10 10 10 10 10 10 10 13 38
38 14 10 10 10 10 10 10 10 10 10 10 10 10 10 10 10 10 29 25 28 10 10 10 10 10 10 10 10 10 10 10 10 29 25 28 10 10 10 10 10 10 10 13 38
38 14 10 10 10 10 10 10 10 10 10 10 10 10 10 10 10 10 29 25 28 10 10 10 10 10 10 10 10 10 10 10 10 29 25 28 10 10 10 10 10 10 10 13 38
38 14 10 10 10 10 10 10 10 10 10 10 10 10 10 10 10 10 29 25 28 10 10 10 10 10 10 10 10 10 10 10 10 29 25 28 10 10 10 10 10 10 10 13 38
38 14 10 10 10 10 10 10 10 10 10 10 10 10 10 10 10 10 29 25 28 10 10 10 10 10 10 10 10 10 10 10 10 29 25 28 10 10 10 10 10 10 10 13 38
38 14 10 10 10 10 10 10 10 10 10 10 10 10 10 10 10 10 29 25 28 10 10 10 10 10 10 10 10 10 10 10 10 29 25 28 10 10 10 10 10 10 10 13 38
38 14 10 10 10 19 11 11 11 11 11 20 10 10 10 10 10 10 29 25 28 10 10 10 10 10 10 10 10 10 10 10 10 32 26 33 10 10 10 10 10 10 10 13 38
38 14 10 10 10 13 24 24 24 24 24 14 10 10 10 10 10 10 29 25 28 10 10 10 10 10 10 10 10 10 10 10 10 10 10 10 10 10 10 10 10 10 10 13 38
38 14 10 10 10 13 24 24 24 24 24 14 10 10 10 10 10 10 29 25 28 10 10 10 10 10 10 10 10 10 10 10 10 10 10 10 10 10 10 10 10 10 10 13 38
38 14 10 10 10 13 24 24 24 24 24 14 10 10 10 10 10 10 29 25 28 10 10 10 10 10 10 10 10 10 10 10 10 10 10 10 10 10 10 10 10 10 10 13 38
38 14 10 10 10 13 24 24 15 12 12 22 10 10 10 10 10 10 29 25 28 10 10 10 10 10 10 10 10 10 10 10 10 10 10 10 10 10 10 10 10 10 10 13 38
38 14 10 10 10 13 24 24 14 10 10 10 10 10 10 10 10 10 29 25 28 10 10 10 10 10 10 10 10 10 10 10 10 10 10 10 10 10 10 10 10 10 10 13 38
38 14 10 10 10 13 24 24 14 10 10 10 10 10 10 10 10 10 29 25 28 10 10 10 10 10 10 10 10 10 10 10 10 10 10 10 10 10 10 10 10 10 10 13 38
38 14 10 10 10 13 24 24 14 10 10 10 10 10 10 10 10 10 29 25 28 10 10 10 10 10 10 10 10 10 10 10 10 10 10 10 10 10 10 10 10 10 10 13 38
38 14 10 10 10 21 12 12 22 10 10 10 10 10 10 10 10 10 29 25 28 10 10 10 10 10 10 10 10 10 10 10 10 10 10 10 10 10 10 10 10 10 10 13 38
38 14 10 10 10 10 10 10 10 10 10 10 10 10 10 10 10 10 29 25 28 10 10 10 10 10 10 10 10 10 10 10 10 10 10 30 27 27 31 10 10 10 10 13 38
38 14 10 10 10 10 10 10 10 10 10 10 10 10 30 27 27 27 37 25 36 27 27 27 31 10 10 10 10 10 10 10 10 10 10 29 25 25 28 10 10 10 10 13 38
38 14 10 10 10 10 10 10 10 10 10 10 10 10 29 25 25 25 25 25 25 25 25 25 28 10 10 10 10 10 10 10 10 10 10 29 25 25 28 10 10 10 10 13 38
38 14 10 10 10 10 10 10 10 10 10 10 10 10 29 25 25 25 25 25 25 25 25 25 28 10 10 10 10 10 10 10 10 10 10 29 25 25 28 10 10 10 10 13 38
38 14 10 10 10 10 10 10 10 10 10 10 10 10 29 25 25 25 25 25 25 25 25 25 28 10 10 10 10 10 10 10 10 10 10 29 25 25 28 10 10 10 10 13 38
38 14 10 10 10 10 10 10 10 10 10 10 10 10 29 25 25 25 25 25 25 25 25 25 28 10 10 10 10 10 10 10 10 10 10 29 25 25 28 10 10 10 10 13 38
38 14 10 10 10 10 10 10 10 10 10 10 10 10 29 25 25 25 25 25 25 25 25 25 28 10 10 10 10 10 10 30 27 27 27 37 25 25 28 10 10 10 10 13 38
38 14 10 10 10 10 10 10 10 10 10 10 10 10 29 25 25 25 25 25 25 25 25 25 28 10 10 10 10 10 10 29 25 25 25 25 25 25 28 10 10 10 10 13 38
38 14 10 10 10 10 10 10 10 10 10 10 10 10 29 25 25 25 25 25 25 25 25 25 28 10 10 10 10 10 10 29 25 25 25 25 25 25 28 10 10 10 10 13 38
38 14 10 10 10 10 10 10 10 10 10 10 10 10 32 26 26 26 26 26 26 26 26 26 33 10 10 10 10 10 10 32 26 26 26 26 26 26 33 10 10 10 10 13 38
38 14 10 10 10 10 10 10 10 10 10 10 10 10 10 10 10 10 10 10 10 10 10 10 10 10 10 10 10 10 10 10 10 10 10 10 10 10 10 10 10 10 10 13 38
38 14 10 10 10 10 10 10 10 10 10 10 10 10 10 10 10 10 10 10 10 10 10 10 10 10 10 10 10 10 10 10 10 10 10 10 10 10 10 10 10 10 10 13 38
38 14 10 10 10 10 10 10 10 10 10 10 10 10 10 10 10 10 10 10 10 10 10 10 10 10 10 10 10 10 10 10 10 10 10 10 10 10 10 10 10 10 10 13 38
38 14 10 10 10 10 10 10 10 10 10 10 10 10 10 10 10 10 10 10 10 10 10 10 10 10 10 10 10 10 10 10 10 10 10 10 10 10 10 10 10 10 10 13 38
38 14 10 10 10 10 10 10 10 10 10 10 10 10 10 10 10 10 10 10 10 10 10 10 10 10 10 10 10 10 10 10 10 10 10 10 10 10 10 10 10 10 10 13 38
38 14 10 10 10 10 10 10 10 10 10 10 10 10 10 10 10 10 10 10 10 10 10 10 10 10 10 10 10 10 10 10 10 10 10 10 10 10 10 10 10 10 10 13 38
38 17 11 11 11 11 11 11 11 11 11 11 11 11 11 11 11 11 11 11 11 11 11 11 11 11 11 11 11 11 11 11 11 11 11 11 11 11 11 11 11 11 11 18 38
38 38 38 38 38 38 38 38 38 38 38 38 38 38 38 38 38 38 38 38 38 38 38 38 38 38 38 38 38 38 38 38 38 38 38 38 38 38 38 38 38 38 38 38 38